jason calacanis: ['jason calacanis', 'jason calcanis']
chilean: ['chilean', 'chile']
east germany: ['east german', 'east germany']
haitian: ['haiti', 'haitian']
gethsemane: ['gethsemane', 'gethsemani']
tuscon: ['tuscon', 'tucson']
senator: ['senate', 'senator']
john mccain: ['john mccain', 'juan mccain']
barrack obama: ['barak obama', 'barrack obama', 'barrak obama', 'barack obama']
disney world: ['disney world', 'disneyworld']
shia islam: ['shi islam', 'shia islam']
shiite: ['shiite', 'shiism']
yisrael: ['yisrael', 'israel', 'isreal']
al quaeda: ['al qaeda', 'al quaeda', 'al qaida']
hillary swank: ['hilary swank', 'hillary swank']
ankara: ['ankara', 'ancyra']
mohame: ['muham', 'mohame']
othman: ['othman', 'uthman']
marxism: ['maoist', 'maoism', 'marxism', 'marxist']
parvatus: ['parvatus', 'parvathi']
mallorca: ['mallorca', 'majorca']
microsoft corp: ['microsoft corp', 'microsoft word']
open office: ['open office', 'openoffice']
reikus: ['reiki', 'reikus']
adolph hitler: ['adolf hitler', 'adolph hitler']
viet nam: ['viet nam', 'vietnam']
montenegrin: ['montenegrin', 'montenegro']
serbium: ['serbia', 'serbium']
hong kong: ['hong kong', 'hongkong']
west virginia: ['west virginia', 'west virgina']
south east europe: ['south east europe', 'southeast europe']
south eastern europe: ['southeastern europe', 'south eastern europe']
romania: ['romania', 'rumania']
tennessee: ['tennessee', 'tennesee']
democratic: ['democrat', 'democratic']
vicodin: ['vicodin', 'vicoden']
grey wolf: ['grey wolf', 'gray wolf']
afghanistan: ['afghanistan', 'afganistan']
afghani: ['afghan', 'afghani']
pashto: ['pashto', 'pashtu']
britney spears: ['britney spear', 'britney spears']
cuban: ['cuban', 'cuba']
roaccutane: ['roaccutane', 'accutane']
jagannatha: ['jagannath', 'jagannatha']
shri krishna: ['sri krishna', 'shri krishna']
tibetan buddhist: ['tibetan buddhist', 'tibetan buddhism']
massachusett: ['massachuset', 'massachusett']
sarkozy: ['sarkozy', 'sarko']
news corp: ['newscorp', 'news corp']
salafist: ['salafist', 'salafism', 'salafi']
sufism: ['sufism', 'sufis', 'sufi']
imam hussein: ['imam husayn', 'imam hussein', 'imam hussain']
bin ladin: ['bin ladin', 'bin laden']
usama bin laden: ['usama bin laden', 'osama bin ladin', 'osama bin laden']
hillary clinton: ['hillary clinton', 'hilary clinton']
condoleezza rice: ['condoleeza rice', 'condoleezza rice', 'condolezza rice']
rwandan: ['uganda', 'rwanda', 'rwandan']
kossovo: ['kossovo', 'kosova']
gibralter: ['gibralter', 'gibraltar']
erik satie: ['erik satie', 'eric satie']
belgium: ['belgium', 'belgian']
malaysian: ['malaysian', 'malaysia']
paralympian: ['paralympic', 'paralympian']
zionism: ['zionism', 'zionist']
judiasm: ['judiasm', 'judaism']
galilea: ['galilea', 'galilee']
satanism: ['satanic', 'satanism']
hinduism: ['hinduism', 'hindus']
aaron copeland: ['aaron copland', 'aaron copeland']
kyiv: ['kyiv', 'kiev']
usa today: ['usatoday', 'usa today']
tamil nadu: ['tamilnadu', 'tamil nadu']
freemasonry: ['freemason', 'freemasonry']
teheran: ['tehran', 'teheran']
pata: ['ata', 'pata']
ogham: ['ogam', 'ogham']
ju jitsu: ['ju jitsu', 'jujutsu']
bir zeit: ['bir zeit', 'birzeit']
black american: ['black american', 'black america']
jet blue: ['jet blue', 'jetblue']
google sync: ['google sync', 'google inc']
google health: ['google earth', 'google health']
google mail: ['google map', 'google mail']
al biruni: ['al biruni', 'alberuni']
isaan: ['isan', 'isaan']
nazism: ['nazism', 'nazi']
dhhs: ['dhhs', 'hhs']
cfid: ['cfid', 'cfs']
homero: ['homero', 'homer']
rabbie burn: ['rabbie burn', 'robbie burn']
joseph stalin: ['josef stalin', 'joseph stalin', 'joe stalin']
collin powell: ['collin powell', 'colin powell']
yemenis: ['yeman', 'yemenis', 'yemeni']
kerbala: ['kerbala', 'karbala']
miletus: ['miletus', 'miletos']
arnold schwarzeneggar: ['arnold schwarzeneggar', 'arnold schwarzenegger']
ernest hemmingway: ['ernest hemingway', 'ernest hemmingway']
marrakech: ['marrakech', 'marrakesh']
acheh: ['acheh', 'aceh']
java script: ['javascript', 'java script']
hezbollah: ['hezbollah', 'hezbullah', 'hizbullah', 'hizballah', 'hizbollah']
nuremberg: ['nuremberg', 'nuremburg']
hastinapura: ['hastinapura', 'hastinapur']
tajiks: ['tajiks', 'tajik']
gautama buddha: ['gautama buddha', 'gautam buddha']
shakyamuni buddha: ['sakyamuni buddha', 'shakyamuni buddha']
shakyamuni: ['sakyamuni', 'shakyamuni']
che guevara: ['che guevara', 'che guevera']
makkah: ['makkah', 'makka']
djakarta: ['jakarta', 'djakarta']
halle berry: ['halle berry', 'halle barry']
tahitian: ['tahitian', 'tahiti']
qaddafi: ['qaddafi', 'gaddafi']
ya akov: ['ya akov', 'yaakov']
beersheva: ['beersheva', 'beersheba']
ishmael: ['ismael', 'ishmael']
leonardo da vinci: ['leonardo da vinci', 'leonardo davinci']
michaelangelo: ['michelangelo', 'michaelangelo']
jehovah: ['jehovah', 'yehovah']
yahweh: ['yahweh', 'yahveh']
nigerians: ['nigeria', 'nigerian', 'nigerians']
islamism: ['islamism', 'islamist']
seattlest: ['seattlest', 'seattle']
mac osx: ['mac osx', 'mac os']
nicole ritchie: ['nicole ritchie', 'nicole richie']
taoism: ['taoism', 'daoism', 'taoist']
lao tze: ['lao tze', 'lao tzu', 'lao zi', 'lao tse', 'laozi']
calvinism: ['calvinism', 'calvinist']
vienna: ['vienna', 'viena']
neopia: ['neopia', 'neopet']
communist: ['communist', 'communism']
brugge: ['bruge', 'brugge']
colin farrell: ['colin farrell', 'colin farrel']
thomas edison: ['thomas edison', 'thoma edison']
dassault systeme: ['dassault systeme', 'dassault system']
babylonian: ['babylonian', 'babylonia']
ashoka: ['ashoka', 'asoka']
magadha: ['magadha', 'magadh']
midyan: ['midyan', 'midian']
quran: ['quran', 'koran']
balaam: ['balaam', 'bilaam']
ramess iii: ['ramess iii', 'ramse iii']
ahmadinejad: ['ahmadinejad', 'ahmadenijad']
wal mart: ['wal mart', 'walmart']
exxon mobil: ['exxonmobil', 'exxon mobil']
nvidium: ['nvidium', 'nvidia']
courteney cox: ['courtney cox', 'courteney cox']
brett farve: ['bret favre', 'brett farve', 'brett favre']
mississippi: ['mississipi', 'mississippi']
disney land: ['disneyland', 'disney land']
jp morgan chase: ['jp morgan chase', 'jpmorgan chase']
milano: ['milan', 'milano']
katharine hepburn: ['katharine hepburn', 'katherine hepburn']
hillary duff: ['hillary duff', 'hilary duff']
ethiopian: ['ethiopia', 'ethiopian']
cate blanchette: ['cate blanchett', 'cate blanchette', 'kate blanchett']
miley ray cyrus: ['miley ray cyrus', 'billy ray cyrus']
terri hatcher: ['terri hatcher', 'teri hatcher']
tattooine: ['tatooine', 'tattooine']
open document format: ['opendocument format', 'open document format']
indo china: ['indochina', 'indo china']
tchad: ['chad', 'tchad']
lukashenko: ['lukashenko', 'lukashenka']
madinah: ['madinah', 'medina']
nephthys: ['nephthys', 'nepthys']
armenian: ['armenian', 'armenia']
phillipine: ['phillipine', 'philippine']
astra zeneca: ['astrazeneca', 'astra zeneca']
bourgas: ['burgas', 'bourgas']
bangalore: ['bangalore', 'bengaluru', 'bangaluru']
information week: ['information week', 'informationweek']
vrindavan: ['vrindavan', 'brindavan', 'vrndavana', 'brindaban']
robert de niro: ['robert de niro', 'robert deniro']
open social: ['opensocial', 'open social']
star office: ['star office', 'staroffice']
krakow: ['krakow', 'cracow']
david sifry: ['david sifry', 'dave sifry']
amber fort: ['amer fort', 'amber fort']
burgandy: ['burgandy', 'burgundy']
moshiach: ['moshiach', 'mashiach']
george frederick handel: ['george frideric handel', 'george frederic handel', 'george frederick handel']
osdn: ['osdn', 'ostg']
dionysos: ['dionysos', 'dionysus']
rafiq hariri: ['rafiq hariri', 'rafik hariri']
binyamin netanyahu: ['binyamin netanyahu', 'benjamin netanyahu']
fijian: ['fiji', 'fijian']
hanoi: ['noi', 'hanoi']
garrison keillor: ['garrison keillor', 'garrison keilor']
taimur: ['timur', 'taimur']
cincinattus: ['cincinattus', 'cincinnatus']
mongolium: ['mongolium', 'mongolian']
benare: ['benare', 'banara']
kangchenjunga: ['kangchenjunga', 'kanchenjunga']
leonardo di caprio: ['leonardo di caprio', 'leonardo dicaprio']
billie joe: ['billie joe', 'billy joe']
chevron texaco: ['chevrontexaco', 'chevron texaco']
starbucks: ['starbucks', 'starbuck']
portugual: ['portugal', 'portugual']
somalia: ['somali', 'somalia']
cape town: ['cape town', 'capetown']
karabagh: ['karabagh', 'karabakh']
chiang kai shek: ['chiang kaishek', 'chiang kai shek']
manichaeism: ['manicheism', 'manichaeism']
madeleine albright: ['madeleine albright', 'madeline albright']
labour day: ['labor day', 'labour day']
dui: ['dui', 'dwi']
rangoon: ['rangoon', 'yangon']
himalayas: ['himalaya', 'himalayas']
yoko: ['ono', 'yoko']
melchisedec: ['melchisedec', 'melchizedek']
jennifer anniston: ['jennifer aniston', 'jennifer anniston']
massoud: ['massoud', 'masood']
mother theresa: ['mother theresa', 'mother teresa']
liv ullmann: ['liv ullmann', 'liv ullman']
deutsche telecom: ['deutsche telecom', 'deutsche telekom']
wahhabism: ['wahabism', 'wahhabi', 'wahhabism']
heather mac donald: ['heather mac donald', 'heather macdonald']
teddy kennedy: ['teddy kennedy', 'ted kennedy']
pinot bianco: ['pinot blanc', 'pinot bianco']
koenigsberg: ['konigsberg', 'koenigsberg']
lynne cheney: ['lynne cheney', 'lynn cheney']
yitzchak rabin: ['yitzchak rabin', 'yitzhak rabin']
ssris: ['ssri', 'ssris']
sky team: ['skyteam', 'sky team']
ebeneezer scrooge: ['ebenezer scrooge', 'ebeneezer scrooge']
delta air line: ['delta air line', 'delta airline']
edgar allan poe: ['edgar allan poe', 'edgar allen poe']
kabballah: ['kabbalah', 'kabballah']
benara hindu university: ['benara hindu university', 'banara hindu university']
red hat: ['redhat', 'red hat']
atheism: ['atheism', 'atheist']
angolan: ['angola', 'angolan']
maha shivaratri: ['mahashivaratri', 'maha shivaratri']
window medium center: ['window medium center', 'window medium centre']
khrushchev: ['khrushchev', 'khruschev']
eugene cernan: ['eugene cernan', 'gene cernan']
search engine optimisation: ['search engine optimisation', 'search engine optimization']
minn: ['minn', 'mn']
jeannette rankin: ['jeanette rankin', 'jeannette rankin']
karttikeya: ['kartikeya', 'karttikeya']
genova: ['genova', 'genoa']
perge: ['perge', 'perga']
ryan phillippe: ['ryan philippe', 'ryan phillippe']
usps: ['up', 'usps']
dan quayle: ['dan quail', 'dan quayle']
ashkenazim: ['ashkenazi', 'ashkenazim']
ashkenazic jews: ['ashkenazi jews', 'ashkenazic jews']
panaji: ['panaji', 'panjim']
bobby fischer: ['bobby fischer', 'bobby fisher']
mahavira: ['mahavira', 'mahavir']
fallujah: ['falluja', 'fallujah']
yudhishthira: ['yudhishtira', 'yudhisthira', 'yudhishthira']
catholicism: ['catholicism', 'catholocism']
dmso: ['msm', 'dmso']
lvov: ['lvov', 'lwow', 'lviv']
esol: ['esol', 'esl']
meerabai: ['meerabai', 'mirabai']
jerash: ['jerash', 'gerasa']
hawaii: ['hawaii', 'hawai']
septimius severus: ['septimius severus', 'septimus severus']
kefallonia: ['kefallonia', 'kefalonia']
kalady: ['kalady', 'kaladi']
shankara: ['sankara', 'shankara']
ryan air: ['ryanair', 'ryan air']
julius caesar: ['julius caesar', 'julius caeser']
asshur: ['ashur', 'asshur']
blue ray: ['blue ray', 'blu ray']
tsvangiraus: ['tsvangiraus', 'tsvangirai']
strasbourg: ['strasbourg', 'strassburg']
boadicea: ['boudica', 'boadicea', 'boudicca']
frederick douglass: ['frederick douglass', 'frederick dougla']
eid al fitr: ['eid al fitr', 'id ul fitr', 'eid ul fitr']
nickelback: ['nickelback', 'nickleback']
warren buffett: ['warren buffet', 'warren buffett']
nicholas cage: ['nicolas cage', 'nicholas cage']
gorbachov: ['gorbachov', 'gorbachev']
napoleon dynamite: ['napoleon dynamite', 'napolean dynamite']
rosh hashanah: ['rosh hashana', 'rosh hashanah']
tuina: ['tui', 'tuina']
lexis nexis: ['lexis nexis', 'lexisnexis']
cspan: ['cspan', 'span']
sasha baron cohen: ['sasha baron cohen', 'sacha baron cohen']
thomas dorsey: ['thoma dorsey', 'thomas dorsey']
moldovia: ['moldovia', 'moldavia']
sacagawea: ['sacagawea', 'sacajawea']
sugreeva: ['sugreeva', 'sugriva']
yekaterinburg: ['yekaterinburg', 'ekaterinburg']
maoris: ['maori', 'maoris']
bastet: ['bast', 'bastet']
tcg: ['tcg', 'ccg']
schiphol airport: ['schiphol airport', 'schipol airport']
babur: ['babur', 'baber']
rahm emmanuel: ['rahm emanuel', 'rahm emmanuel']
hannover: ['hanover', 'hannover']
nashik: ['nasik', 'nashik']
sikhs: ['sikh', 'sikhs']
hai phong: ['haiphong', 'hai phong']
channukah: ['channukah', 'chanuka', 'hanukah', 'hanukkah']
shabbat: ['shabbat', 'shabbos']
moqtada al sadr: ['moqtada al sadr', 'muqtada al sadr']
kaohsiung: ['kaohsiung', 'kaoshiung']
kuan yin: ['kuan yin', 'kwan yin', 'quan yin']
melanesian: ['melanesian', 'melanesia']
dasharatha: ['dasharatha', 'dasaratha']
neal stephenson: ['neal stephenson', 'neil stephenson']
mordechai: ['mordecai', 'mordechai']
basel: ['basel', 'basle']
vijayawada: ['vijayawada', 'vijaywada']
jeddah: ['jeddah', 'jidda']
bhubaneshwar: ['bhubaneswar', 'bhubaneshwar']
nataraja: ['nataraj', 'nataraja']
sri chaitanya mahaprabhu: ['sri caitanya mahaprabhu', 'sri chaitanya mahaprabhu']
chaitanya mahaprabhu: ['chaitanya mahaprabhu', 'caitanya mahaprabhu']
prahlada: ['prahlad', 'prahlada']
kirkcaldy: ['kirkcaldy', 'kirkaldy']
kether: ['keter', 'kether']
malkuth: ['malkuth', 'malkhut']
maois: ['maoi', 'maois']
nathanael: ['nathanael', 'nathaniel']
bokhara: ['bokhara', 'bukhara']
vasant panchami: ['vasant panchami', 'basant panchami']
tutankhaten: ['tutankhaten', 'tutankhaman', 'tutankhamun']
balarama: ['balarama', 'balaram']
phoenician: ['phoenician', 'phoenicia']
harper collin: ['harper collin', 'harpercollin']
ibn khaldoun: ['ibn khaldun', 'ibn khaldoun']
kelsey grammer: ['kelsey grammer', 'kelsey grammar']
hessen: ['hesse', 'hessen']
hdri: ['hdr', 'hdri']
neo nazis: ['neo nazis', 'neo nazi']
eastre: ['eastre', 'eostre']
chicken pox: ['chickenpox', 'chicken pox']
social worker: ['social worker', 'social work']
missy elliott: ['missy elliot', 'missy elliott']
shekhinah: ['shekhina', 'shekhinah']
cerridwen: ['ceridwen', 'cerridwen']
alan arkin: ['alan arkin', 'adam arkin']
nafplion: ['nafplio', 'nafplion']
leiden: ['leiden', 'leyden']
khadijah: ['khadijah', 'khadija']
botticelli: ['boticelli', 'botticelli']
yazoo: ['yaz', 'yazoo']
central american: ['central american', 'central america']
ranthambhore national park: ['ranthambhore national park', 'ranthambore national park']
horacio: ['horacio', 'horace']
boot camp: ['boot camp', 'bootcamp']
khalil gibran: ['khalil gibran', 'kahlil gibran']
vraja: ['vraja', 'braj']
nanking: ['nanking', 'nanjing']
ntfs: ['ntfs', 'ntf']
sharon osbourne: ['sharon osbourne', 'sharon osborne']
hamath: ['hamath', 'hama']
da nang: ['da nang', 'danang']
medicis: ['medici', 'medicis']
cochin: ['kochi', 'cochin']
george whitefield: ['george whitfield', 'george whitefield']
buproprion: ['bupropion', 'buproprion']
nachshon: ['nachshon', 'nahshon']
andalucia: ['andalucia', 'andalusia']
porbander: ['porbander', 'porbandar']
pat benetar: ['pat benetar', 'pat benatar']
zakat: ['zakat', 'zakah']
eretz yisrael: ['eretz israel', 'eretz yisrael']
ganesha: ['ganesha', 'ganesh']
cheiron: ['chiron', 'cheiron']
darpa: ['darpa', 'arpa']
transdniestrium: ['transnistrium', 'transdniestrium']
elisabeth hasselbeck: ['elisabeth hasselbeck', 'elizabeth hasselbeck']
debary: ['debary', 'bary']
halebidu: ['halebid', 'halebidu']
yuyuan: ['yuyuan', 'yuan']
koh samui: ['ko samui', 'koh samui']
johore: ['johor', 'johore']
rafael benitez: ['rafael benitez', 'rafa benitez']
vashisht: ['vashisht', 'vasishta']
batumi: ['batum', 'batumi']
ibn battuta: ['ibn battuta', 'ibn batuta']
xian: ['xi', 'xian']
macao: ['macao', 'macau']
ba gua zhang: ['baguazhang', 'ba gua zhang']
mount blanc: ['mont blanc', 'mount blanc']
bolshevism: ['bolshevik', 'bolshevism']
galileo: ['galileo', 'galilei']
atharva veda: ['atharva veda', 'atharvaveda']
bodh gaya: ['bodh gaya', 'bodhgaya']
dhonus: ['dhoni', 'dhonus']
kasimir: ['kasimir', 'kazimir']
mohini attam: ['mohini attam', 'mohiniyattam']
thorn: ['thorn', 'torun']
alor setar: ['alor setar', 'alor star']
