jason calacanis: ['jason calacanis', 'jason calcanis']
chilean: ['chilean', 'chile']
east germany: ['east german', 'east germany']
haitian: ['haitian', 'haiti']
gethsemani: ['gethsemani', 'gethsemane']
tuscon: ['tuscon', 'tucson']
barrack obama: ['barrack obama', 'barrak obama', 'barak obama', 'barack obama']
juan mccain: ['juan mccain', 'john mccain']
senator: ['senate', 'senator']
disney world: ['disney world', 'disneyworld']
shiite: ['shiite', 'shiism']
shia islam: ['shi islam', 'shia islam']
yisrael: ['yisrael', 'isreal', 'israel']
al quaeda: ['al qaeda', 'al quaeda', 'al qaida']
hillary swank: ['hilary swank', 'hillary swank']
ancyra: ['ancyra', 'ankara']
uthman: ['uthman', 'othman']
mohame: ['mohame', 'muham']
marxism: ['marxism', 'marxist', 'maoism', 'maoist']
parvathi: ['parvathi', 'parvatus']
mallorca: ['mallorca', 'majorca']
microsoft word: ['microsoft word', 'microsoft corp']
open office: ['openoffice', 'open office']
reikus: ['reiki', 'reikus']
adolph hitler: ['adolph hitler', 'adolf hitler']
viet nam: ['viet nam', 'vietnam']
montenegrin: ['montenegro', 'montenegrin']
serbium: ['serbia', 'serbium']
hong kong: ['hongkong', 'hong kong']
west virginia: ['west virginia', 'west virgina']
south eastern europe: ['south eastern europe', 'southeastern europe']
south east europe: ['south east europe', 'southeast europe']
rumania: ['rumania', 'romania']
tennessee: ['tennessee', 'tennesee']
democratic: ['democrat', 'democratic']
vicodin: ['vicodin', 'vicoden']
grey wolf: ['grey wolf', 'gray wolf']
afghani: ['afghani', 'afghan']
afghanistan: ['afghanistan', 'afganistan']
pashtu: ['pashtu', 'pashto']
britney spears: ['britney spears', 'britney spear']
cuban: ['cuban', 'cuba']
roaccutane: ['accutane', 'roaccutane']
jagannatha: ['jagannath', 'jagannatha']
shri krishna: ['shri krishna', 'sri krishna']
tibetan buddhism: ['tibetan buddhism', 'tibetan buddhist']
massachusett: ['massachuset', 'massachusett']
sarkozy: ['sarkozy', 'sarko']
news corp: ['newscorp', 'news corp']
salafist: ['salafist', 'salafism', 'salafi']
imam hussein: ['imam hussein', 'imam husayn', 'imam hussain']
sufism: ['sufi', 'sufism', 'sufis']
bin ladin: ['bin ladin', 'bin laden']
osama bin ladin: ['osama bin ladin', 'usama bin laden', 'osama bin laden']
hillary clinton: ['hillary clinton', 'hilary clinton']
condoleezza rice: ['condoleeza rice', 'condoleezza rice', 'condolezza rice']
rwandan: ['rwandan', 'uganda', 'rwanda']
kossovo: ['kosova', 'kossovo']
gibraltar: ['gibraltar', 'gibralter']
eric satie: ['eric satie', 'erik satie']
belgium: ['belgium', 'belgian']
malaysian: ['malaysia', 'malaysian']
paralympian: ['paralympian', 'paralympic']
judaism: ['judaism', 'judiasm']
zionism: ['zionism', 'zionist']
galilee: ['galilee', 'galilea']
satanism: ['satanic', 'satanism']
hinduism: ['hindus', 'hinduism']
aaron copeland: ['aaron copland', 'aaron copeland']
kyiv: ['kyiv', 'kiev']
usa today: ['usatoday', 'usa today']
tamil nadu: ['tamilnadu', 'tamil nadu']
freemasonry: ['freemasonry', 'freemason']
teheran: ['teheran', 'tehran']
pata: ['ata', 'pata']
ogham: ['ogam', 'ogham']
ju jitsu: ['jujutsu', 'ju jitsu']
bir zeit: ['bir zeit', 'birzeit']
black american: ['black american', 'black america']
jet blue: ['jetblue', 'jet blue']
google sync: ['google sync', 'google inc']
google health: ['google earth', 'google health']
google mail: ['google map', 'google mail']
al biruni: ['al biruni', 'alberuni']
isaan: ['isaan', 'isan']
nazism: ['nazi', 'nazism']
dhhs: ['dhhs', 'hhs']
cfid: ['cfs', 'cfid']
homero: ['homer', 'homero']
robbie burn: ['robbie burn', 'rabbie burn']
joseph stalin: ['joe stalin', 'josef stalin', 'joseph stalin']
collin powell: ['collin powell', 'colin powell']
yemenis: ['yemeni', 'yemenis', 'yeman']
karbala: ['karbala', 'kerbala']
miletos: ['miletos', 'miletus']
arnold schwarzeneggar: ['arnold schwarzeneggar', 'arnold schwarzenegger']
ernest hemmingway: ['ernest hemmingway', 'ernest hemingway']
marrakech: ['marrakech', 'marrakesh']
acheh: ['aceh', 'acheh']
java script: ['java script', 'javascript']
hezbullah: ['hezbullah', 'hizbollah', 'hizballah', 'hizbullah', 'hezbollah']
nuremburg: ['nuremburg', 'nuremberg']
hastinapura: ['hastinapura', 'hastinapur']
tajiks: ['tajiks', 'tajik']
shakyamuni: ['shakyamuni', 'sakyamuni']
gautama buddha: ['gautama buddha', 'gautam buddha']
shakyamuni buddha: ['sakyamuni buddha', 'shakyamuni buddha']
che guevera: ['che guevera', 'che guevara']
makkah: ['makka', 'makkah']
djakarta: ['jakarta', 'djakarta']
halle berry: ['halle berry', 'halle barry']
tahitian: ['tahiti', 'tahitian']
gaddafi: ['gaddafi', 'qaddafi']
ya akov: ['ya akov', 'yaakov']
beersheva: ['beersheva', 'beersheba']
ishmael: ['ismael', 'ishmael']
leonardo da vinci: ['leonardo davinci', 'leonardo da vinci']
michaelangelo: ['michaelangelo', 'michelangelo']
jehovah: ['jehovah', 'yehovah']
yahveh: ['yahveh', 'yahweh']
nigerians: ['nigeria', 'nigerian', 'nigerians']
islamism: ['islamism', 'islamist']
seattlest: ['seattle', 'seattlest']
mac osx: ['mac os', 'mac osx']
nicole ritchie: ['nicole ritchie', 'nicole richie']
taoist: ['taoist', 'taoism', 'daoism']
lao tzu: ['laozi', 'lao zi', 'lao tzu', 'lao tze', 'lao tse']
calvinism: ['calvinism', 'calvinist']
vienna: ['viena', 'vienna']
neopet: ['neopet', 'neopia']
communism: ['communism', 'communist']
brugge: ['bruge', 'brugge']
colin farrell: ['colin farrell', 'colin farrel']
thomas edison: ['thoma edison', 'thomas edison']
dassault systeme: ['dassault systeme', 'dassault system']
babylonian: ['babylonia', 'babylonian']
ashoka: ['ashoka', 'asoka']
magadha: ['magadha', 'magadh']
midian: ['midian', 'midyan']
quran: ['quran', 'koran']
bilaam: ['bilaam', 'balaam']
ramess iii: ['ramse iii', 'ramess iii']
ahmadenijad: ['ahmadenijad', 'ahmadinejad']
wal mart: ['walmart', 'wal mart']
exxon mobil: ['exxonmobil', 'exxon mobil']
nvidium: ['nvidium', 'nvidia']
courteney cox: ['courteney cox', 'courtney cox']
brett farve: ['bret favre', 'brett farve', 'brett favre']
mississippi: ['mississipi', 'mississippi']
disney land: ['disneyland', 'disney land']
jp morgan chase: ['jpmorgan chase', 'jp morgan chase']
milano: ['milan', 'milano']
katharine hepburn: ['katharine hepburn', 'katherine hepburn']
hillary duff: ['hilary duff', 'hillary duff']
ethiopian: ['ethiopia', 'ethiopian']
cate blanchette: ['cate blanchette', 'kate blanchett', 'cate blanchett']
miley ray cyrus: ['miley ray cyrus', 'billy ray cyrus']
terri hatcher: ['teri hatcher', 'terri hatcher']
tattooine: ['tattooine', 'tatooine']
open document format: ['open document format', 'opendocument format']
indo china: ['indochina', 'indo china']
tchad: ['chad', 'tchad']
lukashenka: ['lukashenka', 'lukashenko']
madinah: ['medina', 'madinah']
nephthys: ['nepthys', 'nephthys']
armenian: ['armenia', 'armenian']
phillipine: ['phillipine', 'philippine']
astra zeneca: ['astra zeneca', 'astrazeneca']
bourgas: ['bourgas', 'burgas']
bengaluru: ['bengaluru', 'bangaluru', 'bangalore']
information week: ['informationweek', 'information week']
vrndavana: ['vrndavana', 'brindavan', 'vrindavan', 'brindaban']
robert de niro: ['robert de niro', 'robert deniro']
open social: ['open social', 'opensocial']
star office: ['staroffice', 'star office']
cracow: ['cracow', 'krakow']
david sifry: ['david sifry', 'dave sifry']
amber fort: ['amber fort', 'amer fort']
burgandy: ['burgandy', 'burgundy']
moshiach: ['moshiach', 'mashiach']
george frederick handel: ['george frederic handel', 'george frederick handel', 'george frideric handel']
ostg: ['ostg', 'osdn']
dionysus: ['dionysus', 'dionysos']
rafik hariri: ['rafik hariri', 'rafiq hariri']
binyamin netanyahu: ['binyamin netanyahu', 'benjamin netanyahu']
fijian: ['fijian', 'fiji']
hanoi: ['noi', 'hanoi']
garrison keillor: ['garrison keillor', 'garrison keilor']
taimur: ['taimur', 'timur']
cincinattus: ['cincinattus', 'cincinnatus']
mongolian: ['mongolian', 'mongolium']
banara: ['banara', 'benare']
kangchenjunga: ['kanchenjunga', 'kangchenjunga']
leonardo di caprio: ['leonardo dicaprio', 'leonardo di caprio']
billie joe: ['billy joe', 'billie joe']
chevron texaco: ['chevron texaco', 'chevrontexaco']
starbucks: ['starbuck', 'starbucks']
portugual: ['portugal', 'portugual']
somalia: ['somalia', 'somali']
cape town: ['cape town', 'capetown']
karabakh: ['karabakh', 'karabagh']
chiang kai shek: ['chiang kai shek', 'chiang kaishek']
manichaeism: ['manichaeism', 'manicheism']
madeleine albright: ['madeleine albright', 'madeline albright']
labour day: ['labour day', 'labor day']
dwi: ['dwi', 'dui']
rangoon: ['yangon', 'rangoon']
himalayas: ['himalayas', 'himalaya']
yoko: ['ono', 'yoko']
melchizedek: ['melchizedek', 'melchisedec']
jennifer anniston: ['jennifer aniston', 'jennifer anniston']
massoud: ['massoud', 'masood']
mother theresa: ['mother teresa', 'mother theresa']
liv ullmann: ['liv ullmann', 'liv ullman']
deutsche telecom: ['deutsche telecom', 'deutsche telekom']
wahhabism: ['wahabism', 'wahhabi', 'wahhabism']
heather mac donald: ['heather mac donald', 'heather macdonald']
teddy kennedy: ['teddy kennedy', 'ted kennedy']
pinot bianco: ['pinot blanc', 'pinot bianco']
koenigsberg: ['konigsberg', 'koenigsberg']
lynne cheney: ['lynne cheney', 'lynn cheney']
yitzchak rabin: ['yitzchak rabin', 'yitzhak rabin']
ssris: ['ssri', 'ssris']
sky team: ['skyteam', 'sky team']
ebeneezer scrooge: ['ebeneezer scrooge', 'ebenezer scrooge']
delta air line: ['delta air line', 'delta airline']
edgar allen poe: ['edgar allen poe', 'edgar allan poe']
kabballah: ['kabballah', 'kabbalah']
banara hindu university: ['banara hindu university', 'benara hindu university']
red hat: ['redhat', 'red hat']
atheism: ['atheism', 'atheist']
angolan: ['angolan', 'angola']
maha shivaratri: ['mahashivaratri', 'maha shivaratri']
window medium centre: ['window medium centre', 'window medium center']
khrushchev: ['khrushchev', 'khruschev']
eugene cernan: ['eugene cernan', 'gene cernan']
search engine optimization: ['search engine optimization', 'search engine optimisation']
minn: ['minn', 'mn']
jeannette rankin: ['jeanette rankin', 'jeannette rankin']
karttikeya: ['karttikeya', 'kartikeya']
genova: ['genoa', 'genova']
perge: ['perge', 'perga']
ryan phillippe: ['ryan phillippe', 'ryan philippe']
usps: ['up', 'usps']
dan quayle: ['dan quayle', 'dan quail']
ashkenazic jews: ['ashkenazi jews', 'ashkenazic jews']
ashkenazim: ['ashkenazim', 'ashkenazi']
panaji: ['panaji', 'panjim']
bobby fischer: ['bobby fisher', 'bobby fischer']
mahavira: ['mahavira', 'mahavir']
fallujah: ['fallujah', 'falluja']
yudhishthira: ['yudhishthira', 'yudhishtira', 'yudhisthira']
catholicism: ['catholicism', 'catholocism']
dmso: ['dmso', 'msm']
lvov: ['lvov', 'lwow', 'lviv']
esol: ['esl', 'esol']
meerabai: ['meerabai', 'mirabai']
jerash: ['jerash', 'gerasa']
hawaii: ['hawai', 'hawaii']
septimius severus: ['septimus severus', 'septimius severus']
kefallonia: ['kefallonia', 'kefalonia']
kaladi: ['kaladi', 'kalady']
shankara: ['shankara', 'sankara']
ryan air: ['ryan air', 'ryanair']
julius caesar: ['julius caesar', 'julius caeser']
asshur: ['asshur', 'ashur']
blue ray: ['blu ray', 'blue ray']
tsvangiraus: ['tsvangiraus', 'tsvangirai']
strasbourg: ['strasbourg', 'strassburg']
boudicca: ['boudica', 'boudicca', 'boadicea']
frederick douglass: ['frederick dougla', 'frederick douglass']
eid ul fitr: ['eid ul fitr', 'eid al fitr', 'id ul fitr']
nickelback: ['nickelback', 'nickleback']
warren buffett: ['warren buffet', 'warren buffett']
nicholas cage: ['nicolas cage', 'nicholas cage']
gorbachov: ['gorbachov', 'gorbachev']
napolean dynamite: ['napolean dynamite', 'napoleon dynamite']
rosh hashanah: ['rosh hashanah', 'rosh hashana']
tuina: ['tui', 'tuina']
lexis nexis: ['lexis nexis', 'lexisnexis']
cspan: ['cspan', 'span']
sacha baron cohen: ['sacha baron cohen', 'sasha baron cohen']
thomas dorsey: ['thoma dorsey', 'thomas dorsey']
moldavia: ['moldavia', 'moldovia']
sacagawea: ['sacagawea', 'sacajawea']
sugreeva: ['sugriva', 'sugreeva']
yekaterinburg: ['ekaterinburg', 'yekaterinburg']
maoris: ['maori', 'maoris']
bastet: ['bastet', 'bast']
tcg: ['tcg', 'ccg']
schiphol airport: ['schipol airport', 'schiphol airport']
babur: ['babur', 'baber']
rahm emmanuel: ['rahm emmanuel', 'rahm emanuel']
hannover: ['hanover', 'hannover']
nashik: ['nashik', 'nasik']
sikhs: ['sikh', 'sikhs']
hai phong: ['hai phong', 'haiphong']
channukah: ['hanukah', 'hanukkah', 'channukah', 'chanuka']
shabbat: ['shabbat', 'shabbos']
muqtada al sadr: ['muqtada al sadr', 'moqtada al sadr']
kaoshiung: ['kaoshiung', 'kaohsiung']
quan yin: ['quan yin', 'kuan yin', 'kwan yin']
melanesian: ['melanesian', 'melanesia']
dasharatha: ['dasharatha', 'dasaratha']
neal stephenson: ['neal stephenson', 'neil stephenson']
mordechai: ['mordechai', 'mordecai']
basle: ['basle', 'basel']
vijayawada: ['vijayawada', 'vijaywada']
jeddah: ['jidda', 'jeddah']
bhubaneshwar: ['bhubaneswar', 'bhubaneshwar']
nataraja: ['nataraja', 'nataraj']
chaitanya mahaprabhu: ['chaitanya mahaprabhu', 'caitanya mahaprabhu']
sri chaitanya mahaprabhu: ['sri chaitanya mahaprabhu', 'sri caitanya mahaprabhu']
prahlada: ['prahlad', 'prahlada']
kirkcaldy: ['kirkcaldy', 'kirkaldy']
kether: ['keter', 'kether']
malkhut: ['malkhut', 'malkuth']
maois: ['maois', 'maoi']
nathanael: ['nathanael', 'nathaniel']
bokhara: ['bokhara', 'bukhara']
basant panchami: ['basant panchami', 'vasant panchami']
tutankhaman: ['tutankhaman', 'tutankhamun', 'tutankhaten']
balarama: ['balarama', 'balaram']
phoenician: ['phoenicia', 'phoenician']
harper collin: ['harper collin', 'harpercollin']
ibn khaldoun: ['ibn khaldun', 'ibn khaldoun']
kelsey grammer: ['kelsey grammer', 'kelsey grammar']
hessen: ['hessen', 'hesse']
hdri: ['hdri', 'hdr']
neo nazis: ['neo nazi', 'neo nazis']
eastre: ['eastre', 'eostre']
chicken pox: ['chicken pox', 'chickenpox']
social worker: ['social work', 'social worker']
missy elliott: ['missy elliot', 'missy elliott']
shekhinah: ['shekhinah', 'shekhina']
cerridwen: ['ceridwen', 'cerridwen']
adam arkin: ['adam arkin', 'alan arkin']
nafplion: ['nafplion', 'nafplio']
leyden: ['leyden', 'leiden']
khadijah: ['khadijah', 'khadija']
botticelli: ['botticelli', 'boticelli']
yazoo: ['yaz', 'yazoo']
central american: ['central america', 'central american']
ranthambhore national park: ['ranthambore national park', 'ranthambhore national park']
horacio: ['horacio', 'horace']
boot camp: ['boot camp', 'bootcamp']
kahlil gibran: ['kahlil gibran', 'khalil gibran']
vraja: ['braj', 'vraja']
nanjing: ['nanjing', 'nanking']
ntfs: ['ntf', 'ntfs']
sharon osbourne: ['sharon osbourne', 'sharon osborne']
hamath: ['hama', 'hamath']
da nang: ['da nang', 'danang']
medicis: ['medicis', 'medici']
cochin: ['cochin', 'kochi']
george whitefield: ['george whitefield', 'george whitfield']
buproprion: ['buproprion', 'bupropion']
nachshon: ['nahshon', 'nachshon']
andalucia: ['andalucia', 'andalusia']
porbandar: ['porbandar', 'porbander']
pat benatar: ['pat benatar', 'pat benetar']
zakat: ['zakat', 'zakah']
eretz yisrael: ['eretz yisrael', 'eretz israel']
ganesha: ['ganesha', 'ganesh']
cheiron: ['chiron', 'cheiron']
darpa: ['arpa', 'darpa']
transdniestrium: ['transnistrium', 'transdniestrium']
elisabeth hasselbeck: ['elisabeth hasselbeck', 'elizabeth hasselbeck']
debary: ['bary', 'debary']
halebidu: ['halebid', 'halebidu']
yuyuan: ['yuan', 'yuyuan']
koh samui: ['ko samui', 'koh samui']
johore: ['johore', 'johor']
rafael benitez: ['rafael benitez', 'rafa benitez']
vashisht: ['vashisht', 'vasishta']
batumi: ['batum', 'batumi']
ibn battuta: ['ibn batuta', 'ibn battuta']
xian: ['xi', 'xian']
macao: ['macao', 'macau']
ba gua zhang: ['ba gua zhang', 'baguazhang']
mount blanc: ['mont blanc', 'mount blanc']
bolshevism: ['bolshevik', 'bolshevism']
galileo: ['galileo', 'galilei']
atharva veda: ['atharvaveda', 'atharva veda']
bodh gaya: ['bodhgaya', 'bodh gaya']
dhonus: ['dhoni', 'dhonus']
kasimir: ['kasimir', 'kazimir']
mohini attam: ['mohini attam', 'mohiniyattam']
thorn: ['thorn', 'torun']
alor setar: ['alor star', 'alor setar']
